111111111111111111111
100010000001000000101
101010111011101111101
101011101000001000001
101000000011001110101
101011011001000100101
101000010001110111101
101011101111000000001
100010101000010101111
111110101011111100001
100000001001000101101
101111101101010100111
100000001001110101101
101111111101000001001
101000001001011111101
100010111000000000001
111111111111111111111
