111111111111111111111
100010000001000000101
101010111011101111101
111011100000010000001
101000001011011110101
101111011001000100101
101000000001110111101
101011101111000100001
100010101000010101111
111110101011111100001
100000101001000101101
101111101101010100111
100000001001110101101
101111111101000001001
101010000001011111101
100010111000000000001
111111111111111111111
