111111111111111111111
100010000001000000101
101110111011101111101
101011101001000000001
101000001011011110111
101111011001000100101
101000000001110110101
101010101111000100001
100010101001010101111
111110111011111100001
100000101001000101101
101111101101010100111
100000001001110101101
101111111101000001001
101000000001011111101
100010111000000000001
111111111111111111111