111111111111111111111
100000000111000110001
100000000111000110001
100011100111000110001
100000100111000110001
100010100111000110001
100010100111000110001
111110100111000110001
111000100111000110001
111011111100000110001
100001110000000110001
100001110111000000001
100001110111000000001
100001110111000110001
100000000111000110001
100000000111000110001
111111111111111111111